11111111111111111111
100000010000E0001001
10C00111000000001101
10000000000000C00001
100000000001000000P1
1001110000000C000001
10010000000111000001
10011100000000001111
100100000C0000000001
11111111111111111111