1111111111111111111111111
100000010000C0001001E0001
10CY011100000000110100001
1000000000Y000C0000111C01
10000YC000000000011100011
111100001111110P000000Y01
1111111111111111111111111