111111111111111111111
100000010000E00010001
10C001110000000011001
10000000000000C000001
100000C00001000001111
111100000001000000001
10000000000100P000001
1001110000000C0000001
100100000C00000000001
111111111111111111111