11111111111111111111
100000010000C0001001
10C00111000000001101
10000000000000C00001
100000C0000000000111
11110000111111000001
10000000P00000C00001
100000C0000000000111
111100000000000000E1
11111111111111111111