11111111111111111111
100000010000E0001001
10C00111000000001101
10000000000000C00001
100000C0000100000111
11110000000100000001
100P0000000100000001
1001110000000C000001
100100000C0000000001
11111111111111111111