11111111111111111111
100000E1000000001001
1010011100C000001101
10000010000000C00001
10000000000000000111
11110000111111000001
1C000000P00000C00001
10000000000000000111
111100000000000000C1
11111111111111111111