111111111111111111111
100000C10000E000100C1
100001110000000011001
1C0000000000000000001
100000000001000001111
1111000C0001000000C01
100000000001000000001
10C111000000000000001
1000000000000000P0001
111111111111111111111